DATE,DESCRIPTION,DEBIT,CREDIT,BALANCE,CLASSIFICATION_TRANS
01-11-2023,000000000122838:,,670.16,2726.697,TRANSFER
02-11-2023,000000000122838:,,617.99,3344.691,TRANSFER
02-11-2023,INW CHQ,209.00,,3135.691,CHQ
05-11-2023,000000000122838:,,609.93,3745.622,TRANSFER
05-11-2023,000000000122838:,,557.00,4302.622,TRANSFER
05-11-2023,000000000122838:,,781.81,5084.434,TRANSFER
06-11-2023,000000000122838:,,451.25,5535.685,TRANSFER
06-11-2023,CASH DEPOSIT-SIN,,700.00,6235.685,CASH
06-11-2023,CASH DEPOSIT-SIN,,500.00,6735.685,CASH
06-11-2023,CASH DEPOSIT-SIN,,190.00,6925.685,CASH
07-11-2023,CASH CHQ,3000.00,,3925.685,CASH
07-11-2023,000000000122838:,,514.98,4440.668,TRANSFER
08-11-2023,CASH CHQ,4000.00,,440.668,CASH
08-11-2023,000000000122838:,,823.34,1264.007,TRANSFER
08-11-2023,CASH DEPOSIT-SIN,,400.00,1664.007,CASH
08-11-2023,CASH DEPOSIT-SIN,,157.50,1821.507,CASH
08-11-2023,CASH DEPOSIT-SIN,,360.00,2181.507,CASH
09-11-2023,000000000122838:,,572.35,2753.857,TRANSFER
09-11-2023,CASH CHQ,2630.00,,123.857,CASH
09-11-2023,CASH DEPOSIT-SIN,,350.00,473.857,CASH
09-11-2023,CASH DEPOSIT-SIN,,200.00,673.857,CASH
09-11-2023,CASH DEPOSIT-SIN,,51.00,724.857,CASH
09-11-2023,CASH DEPOSIT-SIN,,210.00,934.857,CASH
09-11-2023,CASH DEPOSIT-SIN,,1799.60,2734.457,CASH
12-11-2023,CASH DEPOSIT-SIN,,500.00,3234.457,CASH
12-11-2023,CASH DEPOSIT-SIN,,450.00,3684.457,CASH
12-11-2023,CASH DEPOSIT-SIN,,450.00,4134.457,CASH
12-11-2023,000000000122838:,,514.07,4648.531,TRANSFER
12-11-2023,000000000122838:,,502.27,5150.802,TRANSFER
12-11-2023,000000000122838:,,948.61,6099.415,TRANSFER
12-11-2023,CASH CHQ,2700.00,,3399.415,CASH
13-11-2023,000000000122838:,,651.64,4051.056,TRANSFER
13-11-2023,CASH DEPOSIT-SIN,,950.00,5001.056,CASH
13-11-2023,CASH DEPOSIT-SIN,,720.00,5721.056,CASH
13-11-2023,CASH DEPOSIT-SIN,,150.00,5871.056,CASH
13-11-2023,CASH CHQ,1500.00,,4371.056,CASH
14-11-2023,CASH DEPOSIT-SIN,,1000.00,5371.056,CASH
14-11-2023,000000000122838:,,531.31,5902.365,TRANSFER
14-11-2023,CASH CHQ,3500.00,,2402.365,CASH
14-11-2023,CASH DEPOSIT-SIN,,800.00,3202.365,CASH
14-11-2023,CASH DEPOSIT-SIN,,140.00,3342.365,CASH
15-11-2023,000000000122838:,,525.59,3867.959,TRANSFER
15-11-2023,CASH DEPOSIT-SIN,,245.00,4112.959,CASH
15-11-2023,CASH DEPOSIT-SIN,,156.00,4268.959,CASH
15-11-2023,CASH DEPOSIT-SIN,,150.00,4418.959,CASH
16-11-2023,000000000122838:,,304.48,4723.440,TRANSFER
16-11-2023,CASH DEPOSIT-SIN,,400.00,5123.440,CASH
16-11-2023,CASH DEPOSIT-SIN,,168.30,5291.740,CASH
16-11-2023,CASH DEPOSIT-SIN,,259.40,5551.140,CASH
16-11-2023,CASH DEPOSIT-SIN,,260.00,5811.140,CASH
19-11-2023,000000000122838:,,830.27,6641.413,TRANSFER
19-11-2023,000000000122838:,,498.13,7139.545,TRANSFER
19-11-2023,000000000122838:,,622.70,7762.244,TRANSFER
19-11-2023,CASH DEPOSIT-SIN,,775.00,8537.244,CASH
19-11-2023,CASH DEPOSIT-SIN,,450.00,8987.244,CASH
19-11-2023,CASH DEPOSIT-SIN,,450.00,9437.244,CASH
19-11-2023,CASH DEPOSIT-SIN,,800.00,10237.244,CASH
19-11-2023,CASH DEPOSIT-SIN,,400.00,10637.244,CASH
19-11-2023,CASH DEPOSIT-SIN,,54.30,10691.544,CASH
19-11-2023,CASH CHQ,6000.00,,4691.544,CASH
19-11-2023,CHQ ISSUE CHARG,6.30,,4685.244,BANK-CHARGES
20-11-2023,000000000122838:,,564.64,5249.880,TRANSFER
20-11-2023,CASH CHQ,700.00,,4549.880,CASH
20-11-2023,CASH DEPOSIT-SIN,,650.00,5199.880,CASH
20-11-2023,CASH DEPOSIT-SIN,,350.00,5549.880,CASH
20-11-2023,CASH DEPOSIT-SIN,,300.00,5849.880,CASH
20-11-2023,CASH DEPOSIT-SIN,,250.00,6099.880,CASH
20-11-2023,CASH DEPOSIT-SIN,,450.00,6549.880,CASH
21-11-2023,000000000122838:,,806.46,7356.336,TRANSFER
21-11-2023,CASH DEPOSIT-SIN,,74.00,7430.336,CASH
21-11-2023,CASH DEPOSIT-SIN,,1000.00,8430.336,CASH
21-11-2023,CASH DEPOSIT-SIN,,380.00,8810.336,CASH
21-11-2023,CASH CHQ,3700.00,,5110.336,CASH
26-11-2023,000000000122838:,,894.47,6004.809,TRANSFER
26-11-2023,000000000122838:,,1118.50,7123.312,TRANSFER
26-11-2023,000000000122838:,,879.14,8002.450,TRANSFER
26-11-2023,000000000122838:,,1165.63,9168.078,TRANSFER
26-11-2023,000000000122838:,,1429.02,10597.096,TRANSFER
26-11-2023,CASH DEPOSIT-SIN,,600.00,11197.096,CASH
26-11-2023,CASH DEPOSIT-SIN,,388.00,11585.096,CASH
26-11-2023,CASH DEPOSIT-SIN,,460.00,12045.096,CASH
26-11-2023,CASH DEPOSIT-SIN,,650.00,12695.096,CASH
26-11-2023,CASH CHQ,6000.00,,6695.096,CASH
27-11-2023,CASH CHQ,2000.00,,4695.096,CASH
27-11-2023,CASH DEPOSIT-SIN,,650.00,5345.096,CASH
27-11-2023,CASH DEPOSIT-SIN,,500.00,5845.096,CASH
27-11-2023,000000000122838:,,869.59,6714.686,TRANSFER
28-11-2023,CASH DEPOSIT-SIN,,800.00,7514.686,CASH
28-11-2023,000000000122838:,,1066.86,8581.550,TRANSFER
28-11-2023,CASH CHQ,4000.00,,4581.550,CASH
29-11-2023,CASH CHQ,1700.00,,2881.550,CASH
29-11-2023,000000000122838:,,812.40,3693.954,TRANSFER
29-11-2023,CASH DEPOSIT-SIN,,390.00,4083.954,CASH
29-11-2023,CASH DEPOSIT-SIN,,110.00,4193.954,CASH
29-11-2023,CASH DEPOSIT-SIN,,800.00,4993.954,CASH
30-11-2023,000000000122838:,,672.30,5666.258,TRANSFER
30-11-2023,CASH DEPOSIT-SIN,,150.00,5816.258,CASH
30-11-2023,CASH DEPOSIT-SIN,,280.00,6096.258,CASH
30-11-2023,CASH DEPOSIT-SIN,,500.00,6596.258,CASH
03-12-2023,INW CHQ,1200.00,,5396.258,CHQ
03-12-2023,INW CHQ,209.00,,5187.258,CHQ
03-12-2023,CASH CHQ,4500.00,,687.258,CASH
03-12-2023,000000000122838:,,1026.14,1713.396,TRANSFER
03-12-2023,000000000122838:,,729.68,2443.076,TRANSFER
03-12-2023,000000000122838:,,1114.72,3557.800,TRANSFER
03-12-2023,CASH DEPOSIT-SIN,,70.00,3627.800,CASH
03-12-2023,CHQ,2310.00,,1317.800,CHQ
04-12-2023,000000000122838:,,662.15,1979.951,TRANSFER
04-12-2023,CASH DEPOSIT-SIN,,1550.00,3529.951,CASH
04-12-2023,CASH DEPOSIT-SIN,,575.00,4104.951,CASH
04-12-2023,CASH CHQ,4000.00,,104.951,CASH
05-12-2023,000000000122838:,,915.86,1020.808,TRANSFER
05-12-2023,CASH DEPOSIT-SIN,,900.00,1920.808,CASH
05-12-2023,CASH DEPOSIT-SIN,,350.00,2270.808,CASH
05-12-2023,CASH DEPOSIT-SIN,,450.00,2720.808,CASH
06-12-2023,000000000122838:,,621.00,3341.808,TRANSFER
06-12-2023,CASH DEPOSIT-SIN,,560.00,3901.808,CASH
06-12-2023,CASH DEPOSIT-SIN,,60.00,3961.808,CASH
06-12-2023,CASH CHQ,1535.00,,2426.808,CASH
07-12-2023,CASH CHQ,500.00,,1926.808,CASH
07-12-2023,CASH DEPOSIT-SIN,,350.00,2276.808,CASH
07-12-2023,CASH DEPOSIT-SIN,,200.00,2476.808,CASH
07-12-2023,000000000122838:,,656.75,3133.562,TRANSFER
07-12-2023,CASH DEPOSIT-SIN,,350.00,3483.562,CASH
07-12-2023,CASH DEPOSIT-SIN,,550.00,4033.562,CASH
07-12-2023,CASH CHQ,3265.00,,768.562,CASH
10-12-2023,CASH DEPOSIT-SIN,,740.00,1508.562,CASH
10-12-2023,CASH DEPOSIT-SIN,,450.00,1958.562,CASH
10-12-2023,000000000122838:,,933.35,2891.908,TRANSFER
10-12-2023,000000000122838:,,784.92,3676.830,TRANSFER
10-12-2023,000000000122838:,,1095.85,4772.681,TRANSFER
10-12-2023,CASH CHQ,4000.00,,772.681,CASH
11-12-2023,CASH CHQ,700.00,,72.681,CASH
11-12-2023,000000000122838:,,695.36,768.038,TRANSFER
11-12-2023,CASH DEPOSIT-SIN,,700.00,1468.038,CASH
11-12-2023,CASH DEPOSIT-SIN,,400.00,1868.038,CASH
11-12-2023,CASH DEPOSIT-SIN,,200.00,2068.038,CASH
11-12-2023,NATIONAL FINANCE,,50000.00,52068.038,CHQ
12-12-2023,000000000122838:,,1038.30,53106.340,TRANSFER
12-12-2023,CASH DEPOSIT-SIN,,300.00,53406.340,CASH
12-12-2023,CASH DEPOSIT-SIN,,650.00,54056.340,CASH
12-12-2023,CASH DEPOSIT-SIN,,285.00,54341.340,CASH
12-12-2023,CASH CHQ,10000.00,,44341.340,CASH
13-12-2023,000000000122838:,,834.13,45175.470,TRANSFER
14-12-2023,000000000122838:,,745.64,45921.106,TRANSFER
14-12-2023,CASH CHQ,27000.00,,18921.106,CASH
14-12-2023,CASH DEPOSIT-SIN,,450.00,19371.106,CASH
14-12-2023,CASH DEPOSIT-SIN,,72.70,19443.806,REVERSED
14-12-2023,CASH DEPOSIT-SIN,,850.00,20293.806,CASH
14-12-2023,REVERSED CASH,72.70,,20221.106,REVERSED
14-12-2023,CASH DEPOSIT-SIN,,92.70,20313.806,CASH
14-12-2023,CASH DEPOSIT-SIN,,300.00,20613.806,CASH
19-12-2023,000000000122838:,,965.11,21578.914,TRANSFER
19-12-2023,000000000122838:,,1284.99,22863.899,TRANSFER
19-12-2023,000000000122838:,,857.38,23721.275,TRANSFER
19-12-2023,CASH DEPOSIT-SIN,,450.00,24171.275,CASH
19-12-2023,CASH DEPOSIT-SIN,,250.00,24421.275,CASH
19-12-2023,CHQ,15000.00,,9421.275,CHQ
19-12-2023,000000000122838:,,889.06,10310.338,TRANSFER
19-12-2023,000000000122838:,,1167.06,11477.399,TRANSFER
20-12-2023,CASH CHQ,500.00,,10977.399,CASH
20-12-2023,000000000122838:,,484.71,11462.110,TRANSFER
20-12-2023,CASH DEPOSIT-SIN,,500.00,11962.110,CASH
20-12-2023,CASH DEPOSIT-SIN,,450.00,12412.110,CASH
21-12-2023,CASH CHQ,6000.00,,6412.110,CASH
21-12-2023,000000000122838:,,544.57,6956.675,TRANSFER
24-12-2023,CASH DEPOSIT-SIN,,820.00,7776.675,CASH
24-12-2023,CASH DEPOSIT-SIN,,850.00,8626.675,CASH
24-12-2023,CASH DEPOSIT-SIN,,70.00,8696.675,CASH
24-12-2023,CASH DEPOSIT-SIN,,150.00,8846.675,CASH
24-12-2023,CASH DEPOSIT-SIN,,850.00,9696.675,CASH
24-12-2023,CASH DEPOSIT-SIN,,650.00,10346.675,CASH
24-12-2023,000000000122838:,,1282.54,11629.214,TRANSFER
24-12-2023,000000000122838:,,1063.73,12692.939,TRANSFER
24-12-2023,000000000122838:,,1557.18,14250.122,TRANSFER
24-12-2023,CASH CHQ,9385.00,,4865.122,CASH
25-12-2023,000000000122838:,,982.14,5847.261,TRANSFER
25-12-2023,CASH DEPOSIT-SIN,,100.00,5947.261,CASH
25-12-2023,CASH DEPOSIT-SIN,,750.00,6697.261,CASH
26-12-2023,000000000122838:,,730.26,7427.524,TRANSFER
26-12-2023,CASH DEPOSIT-SIN,,250.00,7677.524,CASH
26-12-2023,CASH DEPOSIT-SIN,,600.00,8277.524,CASH
26-12-2023,CASH DEPOSIT-SIN,,500.00,8777.524,CASH
26-12-2023,CASH CHQ,2000.00,,6777.524,CASH
26-12-2023,CHQ ISSUE CHARG,6.30,,6771.224,BANK-CHARGES
27-12-2023,000000000122838:,,593.16,7364.387,TRANSFER
28-12-2023,000000000122838:,,770.42,8134.803,TRANSFER
28-12-2023,CASH DEPOSIT-SIN,,750.00,8884.803,CASH
28-12-2023,CASH DEPOSIT-SIN,,200.00,9084.803,CASH
28-12-2023,CASH DEPOSIT-SIN,,43.40,9128.203,CASH
31-12-2023,MIN BAL CHRG,0.53,,9127.678,MIN-BALANCE
31-12-2023,000000000122838:,,1041.14,10168.813,TRANSFER
31-12-2023,000000000122838:,,889.94,11058.749,TRANSFER
31-12-2023,000000000122838:,,994.58,12053.329,TRANSFER
31-12-2023,CASH DEPOSIT-SIN,,537.00,12590.329,CASH
31-12-2023,CASH DEPOSIT-SIN,,159.80,12750.129,CASH
31-12-2023,CASH DEPOSIT-SIN,,59.50,12809.629,CASH
31-12-2023,CASH CHQ,7639.00,,5170.629,CASH
01-01-2024,000000000122838:,,579.02,5749.646,TRANSFER
02-01-2024,000000000122838:,,892.56,6642.206,TRANSFER
02-01-2024,CHQ,510.00,,6132.206,CHQ
02-01-2024,CHQ,2310.00,,3822.206,CHQ
02-01-2024,INW CHQ,209.00,,3613.206,CHQ
02-01-2024,CASH DEPOSIT-SIN,,52.50,3665.706,CASH
02-01-2024,CASH DEPOSIT-SIN,,115.50,3781.206,CASH
03-01-2024,000000000122838:,,837.60,4618.809,TRANSFER
03-01-2024,CASH DEPOSIT-SIN,,150.00,4768.809,CASH
03-01-2024,CASH DEPOSIT-SIN,,1000.00,5768.809,CASH
04-01-2024,000000000122838:,,619.08,6387.888,TRANSFER
04-01-2024,CASH DEPOSIT-SIN,,1000.00,7387.888,CASH
04-01-2024,CASH DEPOSIT-SIN,,45.00,7432.888,CASH
04-01-2024,CASH CHQ,7000.00,,432.888,CASH
07-01-2024,CASH DEPOSIT-SIN,,750.00,1182.888,CASH
07-01-2024,CASH DEPOSIT-SIN,,375.00,1557.888,CASH
07-01-2024,CASH DEPOSIT-SIN,,700.00,2257.888,CASH
07-01-2024,CASH DEPOSIT-SIN,,200.00,2457.888,CASH
07-01-2024,CASH DEPOSIT-SIN,,300.00,2757.888,CASH
07-01-2024,CASH DEPOSIT-SIN,,197.00,2954.888,CASH
07-01-2024,CASH DEPOSIT-SIN,,855.00,3809.888,CASH
07-01-2024,CASH DEPOSIT-SIN,,500.00,4309.888,CASH
07-01-2024,000000000122838:,,1270.19,5580.077,TRANSFER
07-01-2024,000000000122838:,,984.53,6564.610,TRANSFER
07-01-2024,000000000122838:,,1114.81,7679.424,TRANSFER
07-01-2024,CASH DEPOSIT-SIN,,700.00,8379.424,CASH
07-01-2024,CASH DEPOSIT-SIN,,45.00,8424.424,CASH
07-01-2024,CASH CHQ,4000.00,,4424.424,CASH
08-01-2024,CASH CHQ,4000.00,,424.424,CASH
08-01-2024,000000000122838:,,834.77,1259.192,TRANSFER
08-01-2024,CASH DEPOSIT-SIN,,625.00,1884.192,CASH
08-01-2024,CASH DEPOSIT-SIN,,650.00,2534.192,CASH
08-01-2024,CASH DEPOSIT-SIN,,290.00,2824.192,CASH
08-01-2024,CASH DEPOSIT-SIN,,300.00,3124.192,CASH
08-01-2024,CASH DEPOSIT-SIN,,290.00,3414.192,CASH
08-01-2024,CASH CHQ,1200.00,,2214.192,CASH
09-01-2024,000000000122838:,,954.70,3168.896,TRANSFER
09-01-2024,CASH DEPOSIT-SIN,,800.00,3968.896,CASH
09-01-2024,CASH DEPOSIT-SIN,,200.00,4168.896,CASH
09-01-2024,CASH DEPOSIT-SIN,,350.00,4518.896,CASH
09-01-2024,CASH DEPOSIT-SIN,,135.00,4653.896,CASH
10-01-2024,000000000122838:,,1098.68,5752.572,TRANSFER
10-01-2024,CASH CHQ,5000.00,,752.572,CASH
10-01-2024,CASH DEPOSIT-SIN,,165.00,917.572,CASH
10-01-2024,CASH DEPOSIT-SIN,,600.00,1517.572,CASH
10-01-2024,CASH DEPOSIT-SIN,,300.00,1817.572,CASH
14-01-2024,000000000122838:,,870.86,2688.436,TRANSFER
14-01-2024,CASH DEPOSIT-SIN,,350.00,3038.436,CASH
14-01-2024,CASH DEPOSIT-SIN,,150.00,3188.436,CASH
14-01-2024,CASH DEPOSIT-SIN,,176.70,3365.136,CASH
14-01-2024,CASH DEPOSIT-SIN,,500.00,3865.136,CASH
14-01-2024,CASH DEPOSIT-SIN,,500.00,4365.136,CASH
14-01-2024,CASH DEPOSIT-SIN,,70.00,4435.136,CASH
14-01-2024,000000000122838:,,960.25,5395.381,TRANSFER
14-01-2024,000000000122838:,,924.07,6319.448,TRANSFER
14-01-2024,000000000122838:,,815.80,7135.252,TRANSFER
14-01-2024,CASH CHQ,3300.00,,3835.252,CASH
15-01-2024,CASH DEPOSIT-SIN,,170.00,4005.252,CASH
15-01-2024,CASH DEPOSIT-SIN,,525.00,4530.252,CASH
15-01-2024,CASH CHQ,3000.00,,1530.252,CASH
15-01-2024,000000000122838:,,933.05,2463.305,TRANSFER
16-01-2024,000000000122838:,,749.40,3212.703,TRANSFER
16-01-2024,CASH DEPOSIT-SIN,,455.00,3667.703,CASH
16-01-2024,CASH DEPOSIT-SIN,,61.60,3729.303,CASH
16-01-2024,CASH DEPOSIT-SIN,,550.00,4279.303,CASH
16-01-2024,CASH DEPOSIT-SIN,,250.00,4529.303,CASH
16-01-2024,CASH DEPOSIT-SIN,,250.00,4779.303,CASH
16-01-2024,CASH CHQ,2000.00,,2779.303,CASH
17-01-2024,000000000122838:,,400.36,3179.665,TRANSFER
17-01-2024,CASH DEPOSIT-SIN,,525.00,3704.665,CASH
17-01-2024,CASH DEPOSIT-SIN,,180.00,3884.665,CASH
17-01-2024,CASH DEPOSIT-SIN,,100.00,3984.665,CASH
18-01-2024,000000000122838:,,297.21,4281.874,TRANSFER
18-01-2024,CASH DEPOSIT-SIN,,170.00,4451.874,CASH
18-01-2024,CASH DEPOSIT-SIN,,110.00,4561.874,CASH
18-01-2024,CASH DEPOSIT-SIN,,212.00,4773.874,CASH
18-01-2024,CASH DEPOSIT-SIN,,565.00,5338.874,CASH
18-01-2024,CASH CHQ,3000.00,,2338.874,CASH
21-01-2024,000000000122838:,,478.08,2816.955,TRANSFER
21-01-2024,000000000122838:,,1027.20,3844.155,TRANSFER
21-01-2024,000000000122838:,,788.87,4633.022,TRANSFER
21-01-2024,CASH CHQ,3000.00,,1633.022,CASH
22-01-2024,000000000122838:,,562.47,2195.489,TRANSFER
22-01-2024,CASH CHQ,1000.00,,1195.489,CASH
23-01-2024,000000000122838:,,1621.18,2816.667,TRANSFER
24-01-2024,000000000122838:,,1149.52,3966.183,TRANSFER
24-01-2024,CASH DEPOSIT-SIN,,200.00,4166.183,CASH
24-01-2024,CASH DEPOSIT-SIN,,112.50,4278.683,CASH
24-01-2024,CASH DEPOSIT-SIN,,250.00,4528.683,CASH
24-01-2024,CASH DEPOSIT-SIN,,350.00,4878.683,CASH
25-01-2024,000000000122838:,,817.31,5695.992,TRANSFER
28-01-2024,CASH CHQ,5000.00,,695.992,CASH
28-01-2024,000000000122838:,,1404.55,2100.544,TRANSFER
28-01-2024,000000000122838:,,990.77,3091.313,TRANSFER
28-01-2024,000000000122838:,,1411.27,4502.586,TRANSFER
29-01-2024,000000000122838:,,1032.58,5535.163,TRANSFER
29-01-2024,CASH DEPOSIT-SIN,,250.00,5785.163,CASH
29-01-2024,CASH DEPOSIT-SIN,,205.00,5990.163,CASH
30-01-2024,000000000122838:,,1494.04,7484.207,TRANSFER
31-01-2024,000000000122838:,,896.80,8381.002,TRANSFER
31-01-2024,CHQ,2310.00,,6071.002,CHQ
31-01-2024,CASH CHQ,2480.00,,3591.002,CASH
31-01-2024,CHQ,510.00,,3081.002,CHQ
01-02-2024,000000000122838:,,833.65,3914.652,TRANSFER
01-02-2024,INW CHQ,209.00,,3705.652,CHQ
01-02-2024,CASH DEPOSIT-SIN,,175.00,3880.652,CASH
04-02-2024,CASH DEPOSIT-SIN,,1350.00,5230.652,CASH
04-02-2024,CASH DEPOSIT-SIN,,400.00,5630.652,CASH
04-02-2024,000000000122838:,,1383.24,7013.889,TRANSFER
04-02-2024,000000000122838:,,919.37,7933.256,TRANSFER
04-02-2024,000000000122838:,,864.53,8797.788,TRANSFER
04-02-2024,CASH CHQ,7000.00,,1797.788,CASH
05-02-2024,000000000122838:,,696.03,2493.816,TRANSFER
06-02-2024,000000000122838:,,1000.56,3494.372,TRANSFER
06-02-2024,CASH CHQ,2000.00,,1494.372,CASH
07-02-2024,000000000122838:,,582.47,2076.837,TRANSFER
11-02-2024,000000000122838:,,778.07,2854.902,TRANSFER
11-02-2024,000000000122838:,,1613.69,4468.592,TRANSFER
11-02-2024,000000000122838:,,599.07,5067.657,TRANSFER
11-02-2024,000000000122838:,,1109.92,6177.574,TRANSFER
11-02-2024,CASH CHQ,5000.00,,1177.574,CASH
13-02-2024,000000000122838:,,688.38,1865.949,TRANSFER
13-02-2024,DESERT INTERNASH,,46726.90,48592.853,INTER-FIRM
13-02-2024,000000000122838:,,354.22,48947.077,TRANSFER
14-02-2024,000000000122838:,,448.91,49395.982,TRANSFER
14-02-2024,CASH CHQ,25000.00,,24395.982,CASH
14-02-2024,CASH DEPOSIT-SIN,,315.00,24710.982,CASH
14-02-2024,CASH DEPOSIT-SIN,,309.80,25020.782,CASH
14-02-2024,CASH DEPOSIT-SIN,,300.00,25320.782,CASH
14-02-2024,CASH DEPOSIT-SIN,,300.00,25620.782,CASH
15-02-2024,000000000122838:,,722.78,26343.560,TRANSFER
15-02-2024,CASH CHQ,6000.00,,20343.560,CASH
15-02-2024,CASH DEPOSIT-SIN,,155.00,20498.560,CASH
15-02-2024,CASH DEPOSIT-SIN,,245.00,20743.560,CASH
15-02-2024,CASH DEPOSIT-SIN,,600.00,21343.560,CASH
18-02-2024,000000000122838:,,789.88,22133.442,TRANSFER
18-02-2024,000000000122838:,,889.26,23022.703,TRANSFER
18-02-2024,000000000122838:,,770.89,23793.591,TRANSFER
18-02-2024,CASH DEPOSIT-SIN,,250.00,24043.591,CASH
18-02-2024,CASH DEPOSIT-SIN,,150.00,24193.591,CASH
19-02-2024,000000000122838:,,718.62,24912.215,TRANSFER
20-02-2024,000000000122838:,,500.74,25412.950,TRANSFER
20-02-2024,TRF FROM SAID,15000.00,,10412.950,TRANSFER
21-02-2024,000000000122838:,,623.84,11036.791,TRANSFER
22-02-2024,000000000122838:,,837.26,11874.046,TRANSFER
25-02-2024,000000000122838:,,1576.00,13450.045,TRANSFER
25-02-2024,000000000122838:,,1279.10,14729.148,TRANSFER
25-02-2024,000000000122838:,,1697.14,16426.285,TRANSFER
26-02-2024,000000000122838:,,1040.82,17467.108,TRANSFER
27-02-2024,CASH CHQ,10000.00,,7467.108,CASH
27-02-2024,000000000122838:,,867.70,8334.812,TRANSFER
28-02-2024,000000000122838:,,811.68,9146.493,TRANSFER
29-02-2024,000000000122838:,,976.01,10122.504,TRANSFER
29-02-2024,CASH DEPOSIT-SIN,,400.00,10522.504,CASH
03-03-2024,000000000122838:,,1273.50,11796.005,TRANSFER
03-03-2024,CASH DEPOSIT-SIN,,2000.00,13796.005,CASH
03-03-2024,CASH DEPOSIT-SIN,,250.00,14046.005,CASH
03-03-2024,CASH DEPOSIT-SIN,,600.00,14646.005,CASH
03-03-2024,CASH DEPOSIT-SIN,,450.00,15096.005,CASH
03-03-2024,CASH DEPOSIT-SIN,,600.00,15696.005,CASH
03-03-2024,000000000122838:,,1557.34,17253.340,TRANSFER
03-03-2024,000000000122838:,,1640.98,18894.321,TRANSFER
03-03-2024,INW CHQ,209.00,,18685.321,CHQ
03-03-2024,CASH CHQ,13000.00,,5685.321,CASH
03-03-2024,INW CHQ,1200.00,,4485.321,CHQ
04-03-2024,000000000122838:,,1527.50,6012.825,TRANSFER
04-03-2024,CHQ,510.00,,5502.825,CHQ
04-03-2024,CHQ,2310.00,,3192.825,CHQ
05-03-2024,000000000122838:,,1525.92,4718.740,TRANSFER
05-03-2024,CASH DEPOSIT-SIN,,850.00,5568.740,CASH
05-03-2024,CASH DEPOSIT-SIN,,600.00,6168.740,CASH
06-03-2024,000000000122838:,,1413.27,7582.012,TRANSFER
07-03-2024,000000000122838:,,702.05,8284.061,TRANSFER
07-03-2024,CASH CHQ,7000.00,,1284.061,CASH
10-03-2024,000000000122838:,,2343.21,3627.274,TRANSFER
10-03-2024,000000000122838:,,1483.81,5111.082,TRANSFER
10-03-2024,000000000122838:,,1479.94,6591.018,TRANSFER
10-03-2024,CASH DEPOSIT-SIN,,300.00,6891.018,CASH
10-03-2024,CASH DEPOSIT-SIN,,350.00,7241.018,CASH
10-03-2024,CASH DEPOSIT-SIN,,1500.00,8741.018,CASH
10-03-2024,CASH DEPOSIT-SIN,,300.00,9041.018,CASH
10-03-2024,CASH DEPOSIT-SIN,,600.00,9641.018,CASH
10-03-2024,CASH DEPOSIT-SIN,,450.00,10091.018,CASH
11-03-2024,000000000122838:,,1125.77,11216.785,TRANSFER
12-03-2024,000000000122838:,,1493.02,12709.808,TRANSFER
12-03-2024,CASH CHQ,12000.00,,709.808,CASH
13-03-2024,000000000122838:,,869.77,1579.573,TRANSFER
14-03-2024,000000000122838:,,565.88,2145.450,TRANSFER
17-03-2024,000000000122838:,,702.07,2847.523,TRANSFER
17-03-2024,000000000122838:,,735.15,3582.674,TRANSFER
17-03-2024,000000000122838:,,1184.50,4767.174,TRANSFER
18-03-2024,000000000122838:,,729.67,5496.843,TRANSFER
19-03-2024,000000000122838:,,494.71,5991.548,TRANSFER
20-03-2024,000000000122838:,,697.03,6688.575,TRANSFER
21-03-2024,000000000122838:,,1003.05,7691.624,TRANSFER
24-03-2024,000000000122838:,,1878.61,9570.232,TRANSFER
24-03-2024,000000000122838:,,738.34,10308.575,TRANSFER
24-03-2024,000000000122838:,,1349.30,11657.873,TRANSFER
25-03-2024,000000000122838:,,602.92,12260.797,TRANSFER
25-03-2024,CASH CHQ,12000.00,,260.797,CASH
26-03-2024,OTHERS DESERT IN,,2023.50,2284.292,INTER-FIRM
26-03-2024,000000000122838:,,654.12,2938.413,TRANSFER
27-03-2024,000000000122838:,,619.94,3558.357,TRANSFER
28-03-2024,000000000122838:,,606.36,4164.721,TRANSFER
31-03-2024,000000000122838:,,753.63,4918.350,TRANSFER
31-03-2024,000000000122838:,,539.77,5458.119,TRANSFER
31-03-2024,000000000122838:,,752.64,6210.755,TRANSFER
31-03-2024,CASH CHQ,1900.00,,4310.755,CASH
01-04-2024,000000000122838:,,709.54,5020.291,TRANSFER
01-04-2024,INW CHQ,209.00,,4811.291,CHQ
01-04-2024,CHQ,1161.00,,3650.291,CHQ
01-04-2024,CHQ,2310.00,,1340.291,CHQ
02-04-2024,000000000122838:,,922.07,2262.364,TRANSFER
02-04-2024,CASH CHQ,2200.00,,62.364,CASH
03-04-2024,000000000122838:,,842.22,904.582,TRANSFER
04-04-2024,000000000122838:,,652.91,1557.494,TRANSFER
04-04-2024,CASH DEPOSIT-SIN,,900.00,2457.494,CASH
04-04-2024,CASH DEPOSIT-SIN,,350.00,2807.494,CASH
04-04-2024,CASH CHQ,2800.00,,7.494,CASH
07-04-2024,000000000122838:,,657.52,665.010,TRANSFER
07-04-2024,000000000122838:,,642.57,1307.578,TRANSFER
07-04-2024,000000000122838:,,877.89,2185.470,TRANSFER
07-04-2024,CASH CHQ,2000.00,,185.470,CASH
08-04-2024,000000000122838:,,441.76,627.227,TRANSFER
08-04-2024,000000000122838:,,41.63,668.859,TRANSFER
14-04-2024,000000000122838:,,919.86,1588.723,TRANSFER
14-04-2024,000000000122838:,,244.46,1833.180,TRANSFER
14-04-2024,000000000122838:,,733.75,2566.928,TRANSFER
15-04-2024,000000000122838:,,108.44,2675.365,TRANSFER
16-04-2024,000000000122838:,,314.47,2989.834,TRANSFER
17-04-2024,000000000122838:,,331.42,3321.252,TRANSFER
18-04-2024,000000000122838:,,319.60,3640.848,TRANSFER
21-04-2024,000000000122838:,,580.80,4221.645,TRANSFER
21-04-2024,000000000122838:,,467.74,4689.380,TRANSFER
21-04-2024,000000000122838:,,791.97,5481.353,TRANSFER
22-04-2024,000000000122838:,,264.27,5745.618,TRANSFER
23-04-2024,000000000122838:,,501.42,6247.042,TRANSFER
24-04-2024,000000000122838:,,480.60,6727.639,TRANSFER
25-04-2024,000000000122838:,,940.90,7668.541,TRANSFER
25-04-2024,CASH CHQ,5000.00,,2668.541,CASH
28-04-2024,000000000122838:,,1364.04,4032.584,TRANSFER
28-04-2024,000000000122838:,,1183.39,5215.978,TRANSFER
28-04-2024,000000000122838:,,1224.48,6440.459,TRANSFER
29-04-2024,000000000122838:,,844.84,7285.301,TRANSFER
30-04-2024,MIN BAL CHRG,0.53,,7284.776,MIN-BALANCE
30-04-2024,000000000122838:,,775.49,8060.264,TRANSFER
01-05-2024,CASH CHQ,4000.00,,4060.264,CASH
01-05-2024,000000000122838:,,527.47,4587.734,TRANSFER
01-05-2024,INW CHQ,209.00,,4378.734,CHQ
01-05-2024,CHQ,2310.00,,2068.734,CHQ
01-05-2024,CHQ,1161.00,,907.734,CHQ
02-05-2024,000000000122838:,,934.89,1842.624,TRANSFER
02-05-2024,SIMON,,400.00,2242.624,CHQ
